likely	likely-,likely-,likely-,likely+,likely-,likely+,likely+,likely-,likely-,likely,likely-	11
looking	looking,Looking,looking,looking,looking,looking,looking,looking	8
post	post,post-,post,post-,post,post-	6
like	like,like,like-,like,like	5
out	out,out,out-,out,out	5
usually	usually,usually,usually,usually,usually	5
they	they,they,they	3
are	Are,are+,are	3
on	on,on,on	3
social	social,social,social	3
relationship	relationship,relationship,relationship	3
generally	generally,Generally,Generally	3
online	online+,online,online	3
always	always,always	2
because	because,because	2
internet	internet,internet	2
getting	getting,Getting	2
ad	ad,ad	2
would	would,would	2
friend	friend,friend	2
but	but,but	2
women	women,Women	2
an	an,an	2
something	something,something	2
write	write,write	2
hang	hang,hang	2
friends	friends,friends	2
man	man,man	2
media	media,media	2
		1
stalked	stalked	1
help	help	1
through	through	1
relationships	relationships	1
strangers	strangers	1
trying	trying	1
ads	ads	1
don't	don't	1
presents	presents	1
them	them	1
lonely	Lonely	1
risk	risk	1
safe	safe-	1
stranger	stranger	1
friendship	friendship	1
lasting	lasting	1
people	people	1
sexually	sexually	1
fail	fail	1
advertise	advertise-	1
giving	giving	1
reply	reply	1
dating	dating	1
approach	approach-	1
email	email	1
be	be	1
approached	approached	1
men	men	1
address	address	1
put	put-	1
about	about	1
working	working	1
involved	involved+	1
wouldn't	wouldn't	1
etc	etc	1
place	place-	1
think	think	1
via	via	1
love	love	1
feel	feel	1
establish	establish+	1
companionship	companionship	1
their	their	1
there	there	1
whom	whom	1
dangers	dangers	1
themselves	themselves	1
meeting	meeting-	1
that	that	1
inclined	inclined+	1
dates	dates	1
general	general	1
than	than+	1
those	those	1
assaulted	assaulted	1
look	look+	1
this	this	1
up	up	1
will	will	1
fun	fun	1
meet	meet	1
want	want	1
jsut	jsut	1
reservations	reservations	1
it	it	1
have	have-	1
seek	seek-	1
angle	angle	1
things	things	1
make	make+	1
sending	sending	1
emotionally	emotionally	1
may	may	1
who	who	1
such	such	1
types	types	1
flirty	flirty+	1
i	I	1
request	request	1
contact	contact	1
having	having	1
