sensitive	sensitive,sensitive,Sensitive,sensitive,sensitive,Sensitive,sensitive,sensitive,sensitive+,sensitive,sensitive+,sensitive,sensitive+,sensitive,sensitive,sensitive,sensitive,sensitive,sensitive,sensitive+,Sensitive	21
fun	fun,fun,FUN,Fun,Fun,fun,Fun,fun,fun+,fun,fun,fun,fun,fun,fun,fun,fun,fun,fun	19
friendly	friendly,friendly,friendly,Friendly,friendly+,friendly+,friendly,friendly,friendly,Friendly,friendly,friendly,friendly	13
assertive	assertive+,assertive,assertive,Assertive,assertive-,assertive+,assertive,assertive-,assertive-,assertive,assertive,assertive,assertive-	13
social	social,social,social+,social,social,social,social,social,social,social,social	11
good	good,good,Good,good,good,good,good,good,Good,good,good	11
open	open+,open,open+,Open,open+,open,open+,open+,Open,open-,open+	11
kind	kind,kind,kind,kind,kind,kind,kind,kind,kind,kind,kind	11
beautiful	BEAUTIFUL,beautiful,beautiful,Beautiful,Beautiful,beautiful,beautiful,Beautiful,beautiful,beautiful	10
strong	strong,strong,strong,strong,strong,Strong,Strong,strong	8
timid	timid+,timid,timid,Timid,timid,timid,timid,timid+	8
passive	passive,passive,passive,passive,passive,passive,passive+,passive	8
smart	smart,smart,smart,smart,smart,Smart,Smart,smart	8
nice	nice,nice,nice,Nice,nice,nice,nice,nice	8
cool	cool,cool,cool,Cool,cool,cool,cool	7
great	great,Great,great,great,great,Great,great	7
usually	usually,usually,usually,usually,usually,usually,usually	7
awesome	Awesome,awesome,awesome,awesome+,Awesome,awesome,awesome	7
too	too,too,too,too,too,too,too	7
know	know,know,know,know,know,know-,know	7
post	post,post-,post,post-,post,post-,post	7
media	media,media,media,media,media,media,media	7
emotional	Emotional,emotional+,emotional+,emotional,emotional,emotional,emotional	7
outgoing	outgoing+,outgoing,outgoing,outgoing-,outgoing,outgoing	6
get	get,get,get,get,get,get	6
shy	shy,shy,shy+,shy,shy,shy	6
caring	caring,Caring,caring+,caring,caring,caring	6
careful	careful+,careful,careful,careful+,careful+,careful+	6
just	just,just,Just,just,Just,just	6
submissive	submissive,submissive,submissive,submissive,submissive+,submissive	6
loving	loving,Loving,loving,loving,loving,loving	6
all	all,all-,all-,all,all	5
friendships	friendships,friendships,friendships,friendships,friendships	5
what	what,what+,what,what-,what	5
love	love,love,love,love,love	5
can	can,can,can,can,can	5
meet	meet,meet,meet,meet-,meet	5
write	write,write,write+,write,write+	5
very	very,very,very,very,very	5
man	man,man,man,man,man	5
through	through,through,through,through,through	5
better	better,better,better,better,better	5
them	them,them,them,them,them	5
friendship	friendship,friendship,friendship,friendship,friendship	5
relationship	relationship,relationship,relationship,relationship,relationship	5
seek	seek-,seek,seek+,seek+,seek+	5
things	things,things,things,things,things	5
make	make,make,make+,make,make	5
hang	hang,hang,hang,hang,hang	5
flirty	flirty,flirty+,flirty,flirty,flirty+	5
when	when+,when,when,when,when	5
attractive	attractive,attractive,attractive,attractive,attractive	5
dating	dating,dating,dating,dating,dating	5
about	about,about,about+,about,about	5
cautious	cautious+,cautious+,cautious+,cautious,cautious+	5
would	would+,would,would,would,would	5
ad	ad,ad,ad,ad,ad	5
general	general,general,general+,general,general	5
at	at,at,at,at,at	5
interested	interested,Interested,interested,interested,interested-	5
relationships	relationships,relationships+,relationships,relationships	4
from	from,from,from,from	4
my	my,my,my,my	4
something	something,something,something,something	4
intelligent	intelligent,intelligent,intelligent,intelligent	4
interesting	Interesting,Interesting,interesting,interesting	4
little	little,little,little,little	4
times	times,times,times,times	4
think	think,think,think,think	4
way	way,way,way,way	4
gentle	gentle+,gentle,gentle,Gentle	4
need	need,need,need,need	4
much	Much,much,much,much	4
those	those,those,those,those	4
different	different,different,different,different+	4
complex	complex,complex,complex,complex	4
an	an,an,an,an	4
with	with,with,with,with	4
strangers	strangers,strangers,strangers	3
activities	activities,activities,activities	3
internet	internet,internet,internet	3
softer	Softer,softer,softer	3
new	new,new,new	3
sexy	Sexy,sexy,sexy	3
themselves	themselves,themselves,themselves+	3
this	this,this,this	3
a	A,A,A	3
so	so,so,so	3
nurturing	nurturing,nurturing,nurturing	3
always	Always,always,always	3
complicated	complicated,complicated,complicated	3
wonderful	wonderful,wonderful,wonderful	3
somewhat	somewhat,somewhat,somewhat	3
who	who,who,who	3
going	going-,going-,going	3
do	do,do,do	3
email	email,email,email	3
tend	tend-,tend,tend	3
across	across,across,across	3
many	Many,many,many	3
point	point,point,point	3
sweet	sweet,sweet,sweet	3
meeting	meeting,meeting+,meeting-	3
it	it,it,it	3
same	same-,same,same-	3
independent	Independent,independent,independent+	3
emotionally	emotionally+,emotionally,emotionally	3
well	well,well,well	3
person	person,person,person	3
around	around,around,around	3
because	because,because,because	3
by	by,by,by	3
or	or,Or,or	3
empathetic	empathetic,empathetic,empathetic	3
lot	lot,lot,lot	3
feminine	Feminine,feminine,feminine+	3
time	time+,time,time	3
having	having,having,having	3
opportunities	opportunities,opportunities-	2
to	to,TO	2
woman	woman,woman	2
minded	minded+,minded+	2
fragile	fragile,fragile	2
fabulous	Fabulous,fabulous	2
drinks	drinks,drinks	2
giving	giving,giving	2
others	others,others	2
involved	involved+,involved+	2
helpers	Helpers,helpers	2
i'm	I'm,i'm	2
working	working,working	2
type	type,type	2
reserved	reserved+,Reserved	2
needs	needs,needs	2
writers	writers,writers	2
catty	Catty,catty	2
don't	don't,don't	2
before	before,before	2
group	group,group	2
writing	writing,writing	2
seeking	seeking,seeking	2
adventurous	adventurous,adventurous	2
hard	hard,Hard	2
exclamation	exclamation,exclamation	2
approached	approached,approached	2
interaction	interaction+,interaction	2
could	could,could	2
place	place-,place	2
first	first,first	2
emotion	emotion,emotion	2
friend	friend,friend	2
sensual	sensual+,sensual	2
take	take,take	2
sure	sure-,sure+	2
request	request,request	2
points	points,points	2
typically	Typically,Typically	2
text	text,text	2
find	find,find	2
pretty	pretty,Pretty	2
words	words,WORDS	2
stupid	stupid,stupid	2
humans	humans,humans	2
sex	sex,sex	2
probably	probably,probably	2
come	come,come+	2
whom	whom,whom	2
wants	wants,wants	2
lonely	lonely,Lonely	2
welcoming	welcoming,welcoming+	2
look	look+,look	2
someone	someone,someone	2
weird	weird,weird	2
being	being,being	2
ads	ads,ads	2
other	other-,other+	2
bit	bit,bit	2
unique	unique,unique	2
either	either,either	2
often	often,often-	2
indirect	indirect,indirect	2
getting	getting,Getting	2
act	act,act	2
into	into,into	2
female	female,female	2
there	there,there	2
was	was,was	2
up	up,up	2
am	am,am	2
you	you,you	2
		1
gf	gf	1
thoughtful	thoughtful	1
attractivee	ATTRACTIVEE	1
hanging	hanging	1
go	go	1
gossip	gossip+	1
conversation	conversation+	1
issues	issues	1
outgoing,caring	outgoing,caring	1
referring	referring	1
concerned	concerned	1
presents	presents	1
beutiful	beutiful	1
risk	risk	1
straightforward	straightforward+	1
far	far	1
bombarded	bombarded	1
fat	fat	1
text/post	text/post	1
forgiving	forgiving+	1
skeletal	skeletal	1
posts	posts	1
gullible	gullible	1
quick	Quick	1
venus	Venus	1
smaller	smaller	1
direct	Direct	1
casual	casual	1
plays	plays	1
deeply	deeply+	1
resilient	resilient	1
hairy	hairy-	1
explore	explore	1
selective	selective+	1
sociable	sociable+	1
sending	sending	1
creeps	creeps	1
surely	surely	1
via	via	1
morals	morals	1
prefer	prefer	1
ask	ask	1
establish	establish+	1
prey	prey	1
therefore	therefore	1
mysterious	mysterious	1
sincere	sincere+	1
posting	posting-	1
inclined	inclined+	1
haha	haha	1
warm	warm	1
baby	baby	1
inclines	inclines+	1
word	word+	1
work	work	1
example	example	1
organized	organized	1
heard	heard	1
sought	sought	1
sharp	sharp	1
awesomer	Awesomer	1
pink	pink	1
varied	varied	1
thing	thing	1
needy	needy	1
amazing	amazing	1
pure	pure	1
answer	answer-	1
half-century	half-century	1
okay	Okay	1
rude	rude	1
may	may	1
misrepresented	misrepresented	1
after	after	1
impulsive	impulsive	1
wrong	wrong	1
abuse	abuse	1
date	date	1
such	such	1
guys	guys	1
grow	grow	1
types	types	1
short	short	1
keeps	keeps	1
tall	tall	1
order	order	1
talk	talk	1
cute	Cute	1
help	help	1
defenders	defenders	1
playful	playful+	1
still	still	1
talkative	talkative-	1
style	style	1
how	how	1
grammatically	grammatically	1
chatty	chatty+	1
hidden	hidden	1
easier	easier+	1
then	then	1
descriptive	descriptive+	1
food	food	1
smarter	smarter	1
males	males	1
socially	socially+	1
homogametic	homogametic	1
term	term	1
each	each+	1
went	went	1
higher	higher	1
side	side+	1
lasting	lasting	1
brunette	brunette	1
oppressed	oppressed	1
sexually	sexually	1
beyond	beyond	1
really	really	1
laid	laid	1
rational	rational	1
hilarious	hilarious	1
obsessive	obsessive	1
correct	correct	1
like-minded	like-minded	1
pathetic	pathetic	1
free	free	1
put	put-	1
wanted	wanted	1
knit	knit	1
bleed	bleed	1
care	care	1
language	language+	1
messages	messages	1
turn	turn	1
invitation	invitation	1
respond	respond	1
already	already	1
occupations	occupations	1
feel	feel	1
relate	relate	1
powerful	powerful	1
welcome	welcome	1
lovable	lovable	1
xx	XX	1
directly	directly-	1
sounds	sounds	1
noticed	noticed	1
guess	guess	1
personalities	personalities	1
girly	girly	1
indicate	indicate	1
leading	leading	1
girls	girls	1
anyone	anyone	1
prone	prone	1
interests	interests	1
shallow	shallow	1
approachable	approachable	1
believe	believe-	1
loved	loved	1
assaulted	assaulted	1
supposed	supposed	1
were	were	1
and	And	1
jsut	jsut	1
trusting	trusting-	1
say	say	1
blond	blond	1
seem	seem	1
speaking	speaking	1
angle	angle	1
pursued	pursued	1
heterosexual	heterosexual	1
creatures	creatures	1
blunt	blunt	1
chromosomes	chromosomes	1
normal	normal	1
most	most	1
girlfriends	girlfriends	1
measured	measured	1
skinny	skinny	1
shop	shop	1
stalked	stalked	1
hyper	hyper+	1
inputing	inputing	1
chances	chances-	1
subtle	subtle	1
aggressive	aggressive	1
fine	Fine	1
based	based	1
situations	situations	1
writer	writer	1
considering	considering	1
fickle	fickle	1
candidates	candidates	1
gods	gods	1
tune	tune+	1
dominant	dominant	1
fluid	Fluid	1
listed	listed	1
reply	reply	1
considerate	considerate	1
places	places	1
insane	insane	1
frame	frame	1
convey	convey+	1
depends	depends	1
individual	individual	1
dumb	dumb	1
fail	fail	1
close	close	1
best	best	1
subject	subject	1
said	said	1
please	please	1
sites	sites	1
romatic	romatic	1
written	written	1
approach	approach-	1
available	available	1
indecisive	indecisive	1
nature	nature	1
weak	weak	1
however	however	1
smileys	smileys	1
extent	extent	1
cities	cities	1
dates	dates	1
last	last	1
wouldn't	wouldn't	1
equal	equal	1
etc	etc	1
sexes	sexes	1
faces	faces	1
tone	tone	1
simple	simple	1
address	address	1
cranium	cranium	1
speak	speak	1
untrusting	untrusting	1
companionship	companionship	1
capable	capable	1
sensative	sensative	1
dangers	dangers	1
life	life	1
educated	educated	1
gay	gay	1
offered	offered	1
these	THESE	1
will	will	1
neat	neat	1
shortened	SHORTENED	1
almost	almost	1
is	is	1
thus	thus	1
in	In	1
if	if	1
author	author	1
perhaps	Perhaps	1
wierd	wierd	1
struggling	struggling	1
difficult	difficult	1
dimb	dimb	1
safe	safe-	1
expand	expand	1
variety	variety	1
spent	spent	1
contact	contact	1
the	The	1
creators	creators	1
spend	spend	1
slutty	slutty	1
competitive	competitive	1
world	world	1
seems	seems	1
source	source	1
has	has	1
apprehensive	apprehensive	1
possibly	possibly	1
cultural	cultural	1
using	using	1
vague	vague+	1
helpful	helpful	1
gossipy	gossipy	1
stranger	stranger	1
texts	texts	1
cooler	cooler	1
specific	specific	1
individuals	individuals	1
become	become	1
soft	soft	1
absolutely	absolutely	1
some	some	1
searching	searching	1
hair	hair	1
choosing	choosing	1
pain	pain	1
supportive	supportive	1
for	For	1
comments	comments+	1
conservative	conservative	1
asking	asking	1
laughing	laughing	1
smiley	smiley	1
patient	patient	1
bold	bold	1
communicate	communicate	1
uptight	Uptight	1
although	although	1
exciting	Exciting	1
surround	surround	1
trustworthy	trustworthy	1
own	own	1
gatherers	gatherers	1
ppl	ppl	1
lively	lively	1
sensetive	Sensetive	1
her	her	1
support	support	1
question	question	1
long	long	1
kidding	kidding	1
compliant	compliant	1
cats	cats	1
forward	forward-	1
i've	I've	1
bitches	bitches	1
motherly	motherly	1
back	back	1
manipulative	manipulative	1
multitasking	multitasking	1
trying	trying	1
they're	They're	1
wise	wise	1
intuitive	intuitive	1
smooth	Smooth	1
excitement	excitement	1
nicest	nicest	1
stabon	stabon	1
similar	similar	1
detailed	detailed+	1
reservations	reservations	1
single	single	1
hobbies	hobbies	1
annoying	annoying	1
advertise	advertise-	1
again	Again	1
clingy	clingy	1
no	no	1
naive	naive	1
draw	draw	1
calculating	calculating	1
persistent	persistent	1
meaning	meaning	1
ghost	ghost	1
ponline	ponline+	1
age	age	1
emotes	emotes	1
hella	hella	1
